############################################
#                                          #
#                                          #  
#                                          #
#                                          #
#                                          #
#                                          #
#                                          #
#                                          #
#                   o   s                       #
#                                          #
#                                          #
#                     p                     # 
#                                          #
#                                          #
#                                          #
#                      b                    #
#                                          #
#                                          #
#                                          #
#                                          #
#                                          #
#                                          #
############################################

