############################################
#      #    #   #   #   #   #              #
#      #  b #   #   #   #   #              #  
########            #              ##      #
#    ##             #              ##      #
#    ##    ###      #           ############
#    ##    ###            ##       ##    ###
#                       ######     ##    ###
#         ###########   ######     ##    ###
#                   #                    ###
#                   #                    ###
#      #     ####   #################    ###
#     ###      ##   ##             ##    ### 
#     ###      ##   ##                     #
#################   ############           #
#                                          #
#           ##                             #
#       #   ##                             #
#       #        #      ####################
#       #        #         ###             #
#       #        ####      ###         p   #
#       #   #    #                #####    #
#       #   #    #                #####    #
############################################







