############################################
########  o           ######################
########       s   o   #####################  
########    s             s      o         #
# s      o            o      o       s     #
#                 s                      o #
#   ##############    ##################   #
#   #    s                     o       #   #
# o #                              s   # o #
#   #  o #########    ###########      #   #
#   #    #                      #   s  #   #
# o #    #   o    o   s         #      #   #
#   # o  #                o     #      # o # 
#   #    #      s            s  #      #   #
#   #    #           o          #  o   # o #
# o #  o #  s     o       o     #      #   #
#   #    #                      #      # s #
#   #    ########################   o  #   #
# o #  s  o   o   o     o        o     #   #
#   #                                  # s #
# o ####################################   #
#         o   o      s     o       o     o #
#  o                         o             #
############################################

