       #   ####        #    
       #      #        #
              #        #
#             ######   #     
#       #          #   # 
#   #   #          #   # 
#   #   #####      #   # 
#   #       ###                        
#   #         #               #
#             #     ######    #                     
#             #               #                
# #####                       #
#                   ###########                 
#                                     
#                                 
      
