##########################
#       # p     #        #
#       #       #        #  
#       #       #        #
#   #######   #######    #
#                        #
#                        #
#     #     #     #      #
#     #############      #
#     ##    #    ##      #
#     ##         ##      #
#                        #
#                        #
#                    
    #
#   #######   #######    #
#       #       #        #
#       #       #        #
##########################

