############################################
########              ######################
########               #####################  
########                                   #
#                                          #
#                                          #
#   ##############    ##################   #
#   #                                  #   #
#   #                                  #   #
#   #    #########    ###########      #   #
#   #    #                      #      #   #
#   #    #                      #      #   #
#   #    #                      #      #   # 
#   #    #                      #      #   #
#   #    #                      #      #   #
#   #    #                      #      #   #
#   #    #                      #      #   #
#   #    ########################      #   #
#   #                                  #   #
#   #                                  #   #
#   ####################################   #
#                                          #
#                                          #
############################################

