##########################
#       # p     #        #
#   s   #       #        #  
#       #       #    s   #
#  s    ###   ###        #
#                        #
#  ooooooo      o      o #
#             o          #
#     ##    #    ##      #
#     ##    #    ##      #
#                        #
#                o       #
#                        #
#   o                    #
#       ###   ###     o  #
#   o    #       #       #
#       #       #        #
##########################

