#####################
#      #    #       #    
#      ##  ##       #
#    s              #
#                   #
#     ########      #
#  p            o   #
#        ##         #
#    o   ##         #
#                   #
#     ########      #
#                   #
#      ##  ##       #
#      #    #       #
#####################                 




                    
