       #    ###    
       #      #         
  oooo        #         
#    o        #    #       
#  ooo    o         #     
#   #    #         #     
#   #    #               
#   #    ######                        
#             #                 
#             #                                     
#             #                                
# #####                        
#                                               
#                                     
#                                 
      
