############################################
########        #b    #                    #
########        #     #           ######   #  
########        #     #                    #
#                                          #
#     o    ##                  ##          #
#          ##   ############   ##          #
#          ##        ##        ##          #
#    #     ##        ##        ##   ###    #
#    #     ######################   ###    #
#    #     ######################   ###    #
#    #     ##                  ##   ###    #
#    #     ##      ###         ##          # 
#    #     ##      ###         ##          #
#    #     ##                  ##    ###   #
#    #     ##             #    ##    ###   #
#    #     ##   ######    #    ##    ###   #
#    #          ######    #          ###   #
#    #                    #                #
#    #    #      p        ##########       #
#    ######     #     #                    #
#               #     #                    #
#               #     #                    #
############################################
