####################
#                  #
#                  #
#    ###           #
#                  #
#                  #
#                  #
#                  #
#   ###         ####
#                  #
#                  #
####################
