##########################
#       # p     #        #
#       #       #        #  
#       #       #        #
#       ###   ###        #
#                        #
#                        #
#                        #
#     #############      #
#     ##    #    ##      #
#     ##    #    ##      #
#                        #
#                        #
#                        #
#                        #
#       ###   ###        #
#       #       #        #
#       #       #        #
##########################

