############################################
#                                          #
#                                          #  
#                                          #
#                                          #
#                                          #
#                                          #
#                                          #
#                                          #
#                                          #
#                                          #
#            ####   ####                   #
#               #   #                      # 
#               #   #                      #
#################   ############           #
#                                          #
#           ##                             #
#       #   ##                             #
#       #        #      ####################
#       #        #         ###             #
#       #        ####      ###             #
#       #   #    #                #####    #
#       #   #    #                #####    #
############################################







