       #   ####        #    
       #      #        #
              #        #
#             ######   #     
#                  #   # 
#   #    #         #   # 
#   #    ###             
#   #      ####                        
#   #         #               #
#             #      #####    #                     
#             #               #                
# #####                       #
#                   ###########                 
#                                     
#                                 
      
