############################################
#      # b  #   #   #   #   #              #
#      #    #   #   #   #   #              #  
########            #              ##      #
#    ##             #              ##      #
#    ##    ###      #           ############
#    ##    ###            ##       ##    ###
#                       ######     ##    ###
#         ###########   ######     ##    ###
#                   #                    ###
#                   #                    ###
#      #     ####   #################    ###
#     ###      ##   ##             ##    ### 
#     ###      ##   ##                     #
#################   ############           #
#                                          #
#           ##               o             #
#       #   ##                             #
#       #        #      ####################
#       #        #         ###             #
#       #        ####      ###             #
#       #   #    #                #####  p #
#       #   #    #                #####    #
############################################







