
                  
                  
    ###########  
    #         #   ##
    #             ##
    #####  
     #  #      # 
     #  #      #
               ###
                  
                  

