       #    ###    
       #      #         
              #         
#             #    #       
#                  #     
#   #    #         #     
#   #    #               
#   #    ######                        
#             #                 
#             #                                     
#             #                                
# #####                        
#                                               
#                                     
#                                 
      
