#################################
#      #p   #     #     #       #
#      #    #     #     #       #  
########                        #
#      #                        #
#      #################   #    #
#                          #    #
#   #                      #    #
#   #    ###############   #    #
#   #    #                      #
#   #    #                      #
#        #      #################
#        #                      #
#        #                  b   #
#      ##########               #
#                        #      #
#                        #      #
#################################




