############################################
########                   ##   ###        #
########                   ##   ###        #  
########            ###    ##   ###     ####
#                          ##              #
#            #####        ######    #      #
#   #            #        #         #      #
#   #            #   #    #         #      #
#   #    ##      #   #    #    #    #      #
#   #    ##      #   #         #    #      #
#   #    ##      #   #         #    #      #
#   #            #   #    #    #    #      #
#                #   #    #         #      # 
#                #   #    #         #      #
#    ##    #######        ###########      #
#    ##                                    #
#    ##                                    #
#    ##    ##########     ###########      #
#    ##                             #      #
#######                             #      #
#######        ############         ##     #
#                        ##                #
#                        ##                #
############################################
