############################################
########      ##              p   ###      #
########      ##                  ###      #  
########                          ###      #
#    #####         ##################      #
#      ######      ##################      #
#        ####                              #
#                                          #
#                      ###########         #
##      ##########     ###########    #    #
##      ##########     ##       ##    #    #
##      #####   ##     ##       ##    #    #
##      #####   ##     ##       ##    #    # 
##      #####   ##  o  ##             #    #
#               ##     ##             #    #
#               ##     ##       ##         #
##################     ##       ##         #
##################     ##       ############
###                                        #
### b                                      #
###    ###################     ########    #
#      ####                          ##    #
#      ####                          ##    #
############################################


